{
    "map": [
        "#####################################################################################################",
        "                                    #     #     #   #     # # #               # # # # #   #   #   # #",
        "# # # ### # ############# ### # ##### ##### ##### ### ##### # # ####### ####### # # # # ### ### ### #",
        "# # #   # #       #   # #   # # #       # #   # #         #           # # #               # # # # # #",
        "### # # ### ####### ### ######### ####### # ### # ######### ### ######### # ############### # # # # #",
        "#   # # #           # #   #   # #                   # #   # # # # # # # #     # # #     #           #",
        "### ####### # # # ### # ### ### # ### ##### ######### # ### # ### # # # # ##### # # ##### ###########",
        "#         # # # #       #   # #     #     #         # #         # #   #       # # # # # #     # #   #",
        "# # # ####### ### ### ### ### # ##### ############### # ##### ### # ### ####### # # # # # ##### # ###",
        "# # #   # #   #     #   #   #       #   #   # # # # #     # #             # # # # #   # #     #   # #",
        "### # ### ### ### ### ### ### ########### ### # # # # ##### ### ### # # ### # # # # ### # ####### # #",
        "#   # # #       # #       #                             # #   # # # # #               # #     #   # #",
        "# # ### ### # ### ### # ### ##### # # ####### # # # ##### # ##### ######### # # # # ### # ####### # #",
        "# #       # #   # #   #         # # #       # # # # # # #                 # # # # #         # # #   #",
        "# # # ### # # ####### # # # ##### ### # # ####### ### # # ### ### ##### # ######### # # # ### # # ###",
        "# # #   # # #   #     # # #     #   # # #     # #           #   #     # #     #     # # #           #",
        "# ### ####### ##### # # # # ######### ### # ### ####### # ######### ##### ####### # # # # ### # # # #",
        "# #       #       # # # # #       #     # #           # #         #     #   #     # # # #   # # # # #",
        "# # # # # # # # # ### ##### # ####### ##### # ### # ##### # ####### ########### # ##### # ######### #",
        "# # # # # # # # #   #     # #     # #     # #   # #   # # #     #           #   #     # #       #   #",
        "# # ### # # ### # ### # ### # # ### ######### # # # ### ######### # ############# # # ### ######### #",
        "# #   # # # #   # #   #   # # #             # # # #             # # # # # #   # # # #   #         # #",
        "# # # # # ##### # # # ##### # ### # # ### # # ##### # ### # ######### # # ### # ##### # # # # # ### #",
        "# # # # # #     # # #     # #   # # #   # # #     # #   # #       # # # #   #       # # # # # # # # #",
        "# # # # ##### # # # # # ### # # # ### ####### # ### # ### # # # ### # # # ### ####### # ### ##### ###",
        "# # # # #     # # # # #   # # # #   #       # #   # # # # # # #                     # #   # # # # # #",
        "# ##### ### # # ##### # ### ### # ########### ######### ### ####### # # # # ##### ##### ##### # # # #",
        "#   # # #   # #     # #   # # # #       # # #             # # #   # # # # #     #     #   #         #",
        "# ### ##### ### ##### # ##### ### # # ### # ####### # # ##### # ##### # ### # ### ##### ### ### # # #",
        "# #         #       # #         # # #             # # #     #       # #   # #   # #   #       # # # #",
        "### ####### ### # ################### ### ####### ####### ### ### # # # # # # ##### ##### # #########",
        "#   #         # #                   #   #       #       #       # # # # # # #           # #   #     #",
        "# # ####### ##### # # ### # # # # ### ### ### ##### # ##### # ############### # ### # ### # ### #####",
        "# #   #         # # #   # # # # # #     #   #     # #     # #   # # # #   # # #   # # #   #         #",
        "# # ####### ######### ##### # ### # # ### # # # ##### # ### # ### # # # ### ### # ##### # # # # # # #",
        "# # # #         #         # #   # # #   # # # #     # #   # #                 # #     # # # # # # # #",
        "##### ##### # ##### # # # # # # ##### ##### ### ##### # ##### # # # # ################# ### ####### #",
        "#           #   #   # # # # # #     #     #   #     # #     # # # # #           #     #   #       # #",
        "### ### # # # ### # ####### ##### ### # ##### # # ##### # # # # # ### ##### ##### ##### ### # ### ###",
        "# # #   # # #   # #       #     # #   #     # # #   #   # # # # # #       #           #   # #   #   #",
        "# ##### ##### ### # # ##### # ##### # # # ##### # ##### # # ######### # ##### # ####### ### # ##### #",
        "#         #     # # #     # #     # # # #     # #     # # #     #     #     # #       #   # #     # #",
        "# ### # ##### ####### ####### ################# # ####### # ######### # # ##### # ############# #####",
        "# #   # #       #           # # # #         # # #       # #     #     # #     # #       #     # # # #",
        "# ### ### # # # # # # ##### ### # # ### # ### ### # # ##### ##### ### ### ############### ####### # #",
        "# #     # # # # # # #     #           # #       # # #   # #   # # #     #         #     #     # #   #",
        "# ### ####### ### # ####### ### # ####### # ######### ### ##### ##### ############# ##### ##### # ###",
        "# #   # # #     # #       #   # #     # # #         #             #             #           # #     #",
        "# ##### # ### ##### ### ### ##### # ### ### ##### # # # # # # # ##### # # # # ### ########### # #####",
        "# #               #   # #       # #   # # #     # # # # # # # #     # # # # #         #             #",
        "# ##### # # # # # # ####### # ##### ### # ##################### # # ########### # ##### ### ### # ###",
        "# # #   # # # # # #     #   #   #               # # # # # #   # # #           # #     #   #   # #   #",
        "### ### ### ### # # # ### # # # ### # # # ####### # # # # # ########### # # # ### # ### ### ##### # #",
        "#       #     # # # #   # # # # #   # # #         #   # #       #     # # # #   # #       #   #   # #",
        "####### ### # ### ####### ##### # # # ### # # ##### ### # ####### ####### # # ### # # # ########### #",
        "#         # # #     #   #     # # # # #   # #         #     # #     #   # # #   # # # #     #   # # #",
        "####### ### # ### ### ### # ####### # # # # # # ### ### ##### # ##### ####### ### # # # ####### # ###",
        "#   #     # # #         # # #   #   # # # # # #   # #               # # #   #   # # # #   # # #     #",
        "### ### ######### # # ####### ##### # # # ##### ##### ### # # # ##### # # ### ######### ### # # #####",
        "#             #   # #     # #   #   # # # #             # # # #   #         #   # # # #       #     #",
        "##### # # # # ### # # ##### # ##### ##### ### # ### # ####### ##### ### # ####### # # ### ##### #####",
        "#     # # # #   # # #     # # #   # #       # #   # #       #         # #     #   #     # # # #     #",
        "##### ####### # ### # ##### # # ####### # # ### ### # ### ### ### # ####### ##### # ####### # # ### #",
        "#         #   #   # #                 # # # #     # #   #   #   # # # # # #   # # #   # # #       # #",
        "# # # # ##### ####### ### # # # ### ### # # # # # ################### # # ##### # # ### # # #########",
        "# # # #     #     #     # # # #   #   # # # # # #     # #           # # # # # # #             # #   #",
        "# ##### ##### ##### # ##### ### ########### # # # # ### # ### # ##### # # # # # # ####### ##### # ###",
        "# #         #     # #     #   #     #     # # # # #         # #           #             #           #",
        "# ##### # ########### # # # # # ##### ### # ### # # # # ######### # # # ### ### # ### ### ### # #####",
        "# # #   #           # # # # # #         # # #   # # # #         # # # #       # #   # #     # #     #",
        "### ### # ### # ############# # # # ########### # ### # # ### ##### # # # # ##### ### ### ##### #####",
        "#       #   # #             # # # #   # #     # # #   # #   #     # # # # #     #   # # # # # #   # #",
        "### # # # # ### # # # ##### ### ### ### # ##### ##### # # # ############### # ######### ### # ##### #",
        "#   # # # #   # # # #     #   #   #           # #     # # #           #     # # # # # #             #",
        "# # ### ########### # # ########### # # # # # ##### # # ### ##### ####### # ### # # # ### ### ##### #",
        "# # #         # # # # #           # # # # # #   #   # #   #     #     #   #           # #   # #   # #",
        "# # ### ### ### # ##### # # # ##### # ### ### ### # # # ##### # # # ##### # ### # ##### # ##### #####",
        "# # #     # #       #   # # #     # #   #   # #   # # #     # # # #     # #   # #                 # #",
        "# ##### ##### ### ##### ##### ##### ##### # # ### ### # # ####### # ##### # # ##### ### # # # ##### #",
        "# #             #     #   #       #     # # # #     # # #     #   #     # # #     #   # # # #       #",
        "# # # # # # # ### # ##### # # # ### ####### # # # # # ### ####### # ######### # # # ### ##### # # # #",
        "# # # # # # #   # #     # # # #   #       # # # # # # #       #   #     # #   # # #   #     # # # # #",
        "##### # # # ####### # ######### ### ####### # # ######### # # ### ####### ### # ######### ###########",
        "#     # # #       # # # # # #     #     # # # #       #   # # #             # #         #     # #   #",
        "# # ### ### # ##### ### # # ### ######### ##### # # ##### ####### # ### # ##### # ### ### # ### # ###",
        "# # #   #   #     #         #       #         # # #   #       #   #   # #   #   #   #   # #         #",
        "# ######### # ##### # # # ##### # ### ####### # # # ##### # ####### ##### ### # # ### ### # # # # ###",
        "# #         #     # # # #     # #   #       # # # #   #   # #           #   # # # # #   # # # # #   #",
        "### # ### # # ####### # # # ######### ############# ##### # ####### ##### # ### ### ######### # # # #",
        "#   # #   # #     # # # # #                   # #       # #   #         # # #             #   # # # #",
        "### ######### ##### ### ### # # ### # ######### ### # # ### # ### # # ### # ### # # ######### #######",
        "#   #                 # #   # #   # #       #     # # #   # # #   # #   # # #   # #         #       #",
        "############# ### # # # ### # # # ### ### ##### ################### ##### # ### ### ### # ### # # # #",
        "#               # # # #   # # # #   #   #   # #   #   # # # #           # # #     #   # #   # # # # #",
        "### # ##### # # # ##### ### # # # # # ####### # ### ### # # ### # # # ##### # # ### # # # # ### # # #",
        "#   # #     # # # # # # #   # # # # #                         # # # #     # # #   # # # # #   # # # #",
        "### ##### # # ##### # ##### # ### # # # # # # # ### # # # # ##### # # # ####### # ##### ### # ##### #",
        "#   #     # #             # #   # # # # # # # #   # # # # #     # # # #     #   #     # #   #     # #",
        "### # # # ### ####### ### # # ##### ##### # ### ####### # # # # ### # # # ##### # # ### ### # # # # #",
        "#   # # # #         #   # # #     #     # # #         # # # # #   # # # #   #   # #   # #   # # # #  ",
        "#####################################################################################################"
    ],
    "row": 101,
    "col": 101
}
