{
    "STEP": 2,
    "MAP": [
        "######",
        "#B####",
        "#C####",
        "#CBB##",
        "#AACA#"
    ]
}
