{
    "STEP": 1,
    "MAP": [
        "##A##",
        "##B##",
        "##A##",
        "##B##",
        "#BAB#",
        "#BAB#",
        "#ABA#"
    ]
}
