{
    "STEP": 1,
    "MAP": [
        "####B##",
        "##A#B##",
        "##BAA##",
        "##ABB##",
        "##AAB##"
    ]
}
