{
    "STEP": 1,
    "MAP": [
        "#######",
        "#######",
        "##C#A##",
        "##CBA##",
        "##BAB##",
        "#CBCBA#",
        "#CCBAA#"
    ]
}
